1 2 3 4 2 2 2 2 5 6 12 13 3 4 1 1 1
1 2 3 4 2 2 2 2 6 2 10 11 3 4 1 1 1
1 2 3 4 2 2 5 6 2 2 17 18 3 4 1 1 1
1 2 3 4 2 2 6 2 2 2 24 25 3 4 1 1 1
1 1 3 4 5 6 10 11 19 20 2 2 3 4 1 1 1
1 1 1 1 1 1 1 1 1 1 2 2 3 4 27 1 1
1 1 3 4 17 18 2 2 2 2 2 2 3 4 27 1 1
1 1 3 4 24 25 2 2 2 2 26 1 1 1 1 1 1
8 9 3 4 2 2 2 2 5 6 2 2 12 13 1 1 1
15 16 3 4 2 2 2 2 6 2 2 2 10 11 1 1 1
22 23 3 4 10 11 5 6 19 20 19 20 10 11 1 1 1
1 1 1 1 1 1 1 1 1 1 1 1 1 1 1 1 1