1 43 14 27 46 46 46 46 14 27 20 20 20 20 20 20 20 20 20 20 20 20 20 20 20 20 20 20 20 20 20 20 20 20 20 20 20 20 20 20 20 20 20 20 20 20 43 1
1 43 15 14 46 46 46 46 15 14 20 20 20 20 20 20 20 20 20 20 20 20 20 20 20 20 20 20 20 20 20 20 20 20 20 20 20 20 20 20 20 20 20 20 20 20 43 1
1 43 46 46 46 46 25 26 46 46 20 20 20 20 20 20 46 47 46 47 20 20 20 20 20 20 20 20 39 51 20 20 20 20 20 20 20 20 20 20 20 20 46 47 46 47 43 1
1 43 46 46 46 46 37 38 46 46 20 20 20 20 20 20 46 46 46 46 20 20 20 20 20 20 20 20 52 53 20 20 20 20 20 20 20 20 20 20 31 54 46 46 46 46 43 1
1 43 46 46 46 46 14 27 46 46 20 20 20 20 39 51 6 7 8 9 39 51 20 20 20 20 20 20 11 12 46 47 46 47 46 47 46 47 42 54 43 43 25 26 46 46 43 1
1 43 46 46 46 46 15 14 46 46 20 20 20 20 52 53 18 20 20 21 52 53 20 20 20 20 20 20 12 46 46 46 46 46 46 46 46 46 43 43 43 43 37 38 46 46 43 10
1 43 46 46 25 26 11 12 43 43 20 20 8 9 43 43 20 20 20 20 46 46 39 51 39 51 46 47 4 5 46 46 46 46 43 43 2 3 14 27 25 26 46 46 46 46 43 22
1 43 46 46 37 38 12 46 43 43 20 20 20 21 46 46 58 59 20 20 46 46 52 53 52 53 46 46 16 17 43 43 46 46 13 14 15 2 15 14 37 38 46 46 43 43 43 34
1 43 46 46 11 12 46 46 46 46 42 54 42 54 25 26 14 27 14 27 46 46 46 46 11 12 43 43 14 27 39 51 46 46 6 7 8 9 2 3 46 46 46 46 14 27 43 1
1 43 46 46 12 46 46 46 46 46 43 43 43 43 37 38 15 14 15 14 46 46 46 46 12 46 13 14 15 14 52 53 46 46 18 20 20 21 15 2 46 46 43 43 15 14 1 1
1 1 43 43 23 1 25 26 25 26 43 43 43 43 43 43 43 43 43 43 39 51 43 43 46 46 20 20 43 43 46 46 46 46 20 20 39 51 43 43 43 43 46 46 46 46 1 1
1 1 1 1 14 36 37 38 37 38 46 46 13 14 13 14 13 14 46 46 52 53 13 14 46 46 58 59 13 14 43 43 43 43 58 59 52 53 13 14 13 14 46 46 46 46 1 1